####################...........###################
#................................................#
#................................................#
#................................................#
#................................................#
#................................................#
#................................................#
#................................................#
#................................................#
#................................................#
..................................................
..................................................
..................................................
..................................................
..................................................
#................................................#
#................................................#
#................................................#
#................................................#
#................................................#
#................................................#
#................................................#
#................................................#
#................................................#
####################...........###################
